000000000000000000000000
000000000000000000000000
000000000000000000000000
000000000000000011110000
000000000000000022221100
000000000000000022222211
000000011110000000000000
000000022220000000000000
000000000000000000000000
110000000000000000000001
221110000000000001111112
222221110000111112222222
222222221111222222222222
222222222222222222222222